..M.................
###############.####
###...#..#......####
##......M.MM....#...
#..####..#...####...
#..#..#########.....
#..#..........##....
#..#...........#####
#..#................
#..#................
#..#................
#MM#################
#...................
#..################.
####..............#.
....MM...MM.......#.
....................
....M.....M.......#.
.....MMMMM........#.
..................#.
