.........###.......#
........M..M.......#
........M..#.......#
##################.#
...................#
.......MMMM........#
#######....#########
##########.........#
.......#.#.........#
.........#########.#
.......#.........M.#
...#####..##########
...#...####........#
...#...............#
...#........#......#
.............#.....#
...#..........#..#.#
...#...........###.#
...#........######.#
...#................
