...##.##############
....M...............
####..##############
#........#.....#....
####..#######..####.
#..#.....#.......MM.
#..#MM####..#..####.
####..#..#..########
#..#.....#.M......#.
#..#..####..#..#####
#......M.......#..#.
####M##..#..####..##
#..#..#..#..#.......
#..#..####..#..#####
#..M............M...
#..#######..####..##
#.....#.....#.......
##########..####..##
#...................
#...................
