...#################
.MM.................
#..################.
#.....M........#..#.
#..##########..#..#.
#.M.........#..#....
#############..#..#.
#..#........M..#..#.
#.########..########
#..............#..#.
#######..#..####..#.
#........#.....#....
#..#############..##
#...................
#..#..#############M
#..#........#.....#.
#..####..####..#..##
#..#..#........#....
#..#..#############.
#....MM.....#.......

